"filename", "language", "Visual Basic", "XML", "HTML", "CSS", "JavaScript", "comment", "blank", "total"
"f:\MANDARA10F\MANDARA10sourceCode10015\mandara10Ver10015\mandara2\ApplicationEvents.vb", "Visual Basic", 0, 0, 0, 0, 0, 0, 1, 1
"f:\MANDARA10F\MANDARA10sourceCode10015\mandara10Ver10015\mandara2\General-Purpose-Form\clsALZS.vb", "Visual Basic", 7, 0, 0, 0, 0, 26, 5, 38
"f:\MANDARA10F\MANDARA10sourceCode10015\mandara10Ver10015\mandara2\General-Purpose-Form\clsGPX.vb", "Visual Basic", 81, 0, 0, 0, 0, 1, 5, 87
"f:\MANDARA10F\MANDARA10sourceCode10015\mandara10Ver10015\mandara2\General-Purpose-Form\clsKML.vb", "Visual Basic", 462, 0, 0, 0, 0, 11, 9, 482
"f:\MANDARA10F\MANDARA10sourceCode10015\mandara10Ver10015\mandara2\General-Purpose-Form\clsShapefile.vb", "Visual Basic", 1375, 0, 0, 0, 0, 145, 202, 1722
"f:\MANDARA10F\MANDARA10sourceCode10015\mandara10Ver10015\mandara2\General-Purpose-Form\clsTileMapService.vb", "Visual Basic", 571, 0, 0, 0, 0, 156, 68, 795
"f:\MANDARA10F\MANDARA10sourceCode10015\mandara10Ver10015\mandara2\General-Purpose-Form\clsTime.vb", "Visual Basic", 392, 0, 0, 0, 0, 180, 40, 612
"f:\MANDARA10F\MANDARA10sourceCode10015\mandara10Ver10015\mandara2\General-Purpose-Form\clsVB6File.vb", "Visual Basic", 1615, 0, 0, 0, 0, 191, 58, 1864
"f:\MANDARA10F\MANDARA10sourceCode10015\mandara10Ver10015\mandara2\General-Purpose-Form\frmAlphaValueSet.Designer.vb", "Visual Basic", 118, 0, 0, 0, 0, 32, 5, 155
"f:\MANDARA10F\MANDARA10sourceCode10015\mandara10Ver10015\mandara2\General-Purpose-Form\frmAlphaValueSet.vb", "Visual Basic", 27, 0, 0, 0, 0, 0, 2, 29
"f:\MANDARA10F\MANDARA10sourceCode10015\mandara10Ver10015\mandara2\General-Purpose-Form\frmArrow.Designer.vb", "Visual Basic", 231, 0, 0, 0, 0, 62, 5, 298
"f:\MANDARA10F\MANDARA10sourceCode10015\mandara10Ver10015\mandara2\General-Purpose-Form\frmArrow.vb", "Visual Basic", 114, 0, 0, 0, 0, 8, 10, 132
"f:\MANDARA10F\MANDARA10sourceCode10015\mandara10Ver10015\mandara2\General-Purpose-Form\frmBackgroundSetting.Designer.vb", "Visual Basic", 147, 0, 0, 0, 0, 44, 5, 196
"f:\MANDARA10F\MANDARA10sourceCode10015\mandara10Ver10015\mandara2\General-Purpose-Form\frmBackgroundSetting.vb", "Visual Basic", 41, 0, 0, 0, 0, 0, 3, 44
"f:\MANDARA10F\MANDARA10sourceCode10015\mandara10Ver10015\mandara2\General-Purpose-Form\frmColor.Designer.vb", "Visual Basic", 175, 0, 0, 0, 0, 50, 5, 230
"f:\MANDARA10F\MANDARA10sourceCode10015\mandara10Ver10015\mandara2\General-Purpose-Form\frmColor.vb", "Visual Basic", 236, 0, 0, 0, 0, 13, 26, 275
"f:\MANDARA10F\MANDARA10sourceCode10015\mandara10Ver10015\mandara2\General-Purpose-Form\frmColorTransparency.Designer.vb", "Visual Basic", 102, 0, 0, 0, 0, 26, 5, 133
"f:\MANDARA10F\MANDARA10sourceCode10015\mandara10Ver10015\mandara2\General-Purpose-Form\frmColorTransparency.vb", "Visual Basic", 17, 0, 0, 0, 0, 0, 6, 23
"f:\MANDARA10F\MANDARA10sourceCode10015\mandara10Ver10015\mandara2\General-Purpose-Form\frmCompassSetting.Designer.vb", "Visual Basic", 185, 0, 0, 0, 0, 53, 5, 243
"f:\MANDARA10F\MANDARA10sourceCode10015\mandara10Ver10015\mandara2\General-Purpose-Form\frmCompassSetting.vb", "Visual Basic", 44, 0, 0, 0, 0, 0, 5, 49
"f:\MANDARA10F\MANDARA10sourceCode10015\mandara10Ver10015\mandara2\General-Purpose-Form\frmCopyObjectName.Designer.vb", "Visual Basic", 203, 0, 0, 0, 0, 53, 5, 261
"f:\MANDARA10F\MANDARA10sourceCode10015\mandara10Ver10015\mandara2\General-Purpose-Form\frmCopyObjectName.vb", "Visual Basic", 221, 0, 0, 0, 0, 0, 19, 240
"f:\MANDARA10F\MANDARA10sourceCode10015\mandara10Ver10015\mandara2\General-Purpose-Form\frmFontSelect.Designer.vb", "Visual Basic", 352, 0, 0, 0, 0, 89, 5, 446
"f:\MANDARA10F\MANDARA10sourceCode10015\mandara10Ver10015\mandara2\General-Purpose-Form\frmFontSelect.vb", "Visual Basic", 120, 0, 0, 0, 0, 0, 24, 144
"f:\MANDARA10F\MANDARA10sourceCode10015\mandara10Ver10015\mandara2\General-Purpose-Form\frmHatchSelecter.Designer.vb", "Visual Basic", 374, 0, 0, 0, 0, 101, 5, 480
"f:\MANDARA10F\MANDARA10sourceCode10015\mandara10Ver10015\mandara2\General-Purpose-Form\frmHatchSelecter.vb", "Visual Basic", 179, 0, 0, 0, 0, 1, 19, 199
"f:\MANDARA10F\MANDARA10sourceCode10015\mandara10Ver10015\mandara2\General-Purpose-Form\frmHatch_Mark.Designer.vb", "Visual Basic", 265, 0, 0, 0, 0, 68, 5, 338
"f:\MANDARA10F\MANDARA10sourceCode10015\mandara10Ver10015\mandara2\General-Purpose-Form\frmHatch_Mark.vb", "Visual Basic", 117, 0, 0, 0, 0, 26, 18, 161
"f:\MANDARA10F\MANDARA10sourceCode10015\mandara10Ver10015\mandara2\General-Purpose-Form\frmHelpBrowser.designer.vb", "Visual Basic", 78, 0, 0, 0, 0, 23, 5, 106
"f:\MANDARA10F\MANDARA10sourceCode10015\mandara10Ver10015\mandara2\General-Purpose-Form\frmHelpBrowser.vb", "Visual Basic", 25, 0, 0, 0, 0, 0, 5, 30
"f:\MANDARA10F\MANDARA10sourceCode10015\mandara10Ver10015\mandara2\General-Purpose-Form\frmLatLonInput10.Designer.vb", "Visual Basic", 216, 0, 0, 0, 0, 59, 5, 280
"f:\MANDARA10F\MANDARA10sourceCode10015\mandara10Ver10015\mandara2\General-Purpose-Form\frmLatLonInput10.vb", "Visual Basic", 32, 0, 0, 0, 0, 7, 0, 39
"f:\MANDARA10F\MANDARA10sourceCode10015\mandara10Ver10015\mandara2\General-Purpose-Form\frmLatLonInputDMS.Designer.vb", "Visual Basic", 316, 0, 0, 0, 0, 83, 5, 404
"f:\MANDARA10F\MANDARA10sourceCode10015\mandara10Ver10015\mandara2\General-Purpose-Form\frmLatLonInputDMS.vb", "Visual Basic", 70, 0, 0, 0, 0, 7, 9, 86
"f:\MANDARA10F\MANDARA10sourceCode10015\mandara10Ver10015\mandara2\General-Purpose-Form\frmMark_Select.Designer.vb", "Visual Basic", 54, 0, 0, 0, 0, 14, 5, 73
"f:\MANDARA10F\MANDARA10sourceCode10015\mandara10Ver10015\mandara2\General-Purpose-Form\frmMark_Select.vb", "Visual Basic", 77, 0, 0, 0, 0, 0, 11, 88
"f:\MANDARA10F\MANDARA10sourceCode10015\mandara10Ver10015\mandara2\General-Purpose-Form\frmMark_Set.Designer.vb", "Visual Basic", 360, 0, 0, 0, 0, 95, 5, 460
"f:\MANDARA10F\MANDARA10sourceCode10015\mandara10Ver10015\mandara2\General-Purpose-Form\frmMark_Set.vb", "Visual Basic", 153, 0, 0, 0, 0, 9, 23, 185
"f:\MANDARA10F\MANDARA10sourceCode10015\mandara10Ver10015\mandara2\General-Purpose-Form\frmMessage.Designer.vb", "Visual Basic", 119, 0, 0, 0, 0, 26, 5, 150
"f:\MANDARA10F\MANDARA10sourceCode10015\mandara10Ver10015\mandara2\General-Purpose-Form\frmMessage.vb", "Visual Basic", 135, 0, 0, 0, 0, 55, 3, 193
"f:\MANDARA10F\MANDARA10sourceCode10015\mandara10Ver10015\mandara2\General-Purpose-Form\frmMessageBox.Designer.vb", "Visual Basic", 81, 0, 0, 0, 0, 23, 5, 109
"f:\MANDARA10F\MANDARA10sourceCode10015\mandara10Ver10015\mandara2\General-Purpose-Form\frmMessageBox.vb", "Visual Basic", 84, 0, 0, 0, 0, 0, 4, 88
"f:\MANDARA10F\MANDARA10sourceCode10015\mandara10Ver10015\mandara2\General-Purpose-Form\frmOption.Designer.vb", "Visual Basic", 698, 0, 0, 0, 0, 188, 5, 891
"f:\MANDARA10F\MANDARA10sourceCode10015\mandara10Ver10015\mandara2\General-Purpose-Form\frmOption.vb", "Visual Basic", 188, 0, 0, 0, 0, 2, 37, 227
"f:\MANDARA10F\MANDARA10sourceCode10015\mandara10Ver10015\mandara2\General-Purpose-Form\frmPictureSelector.Designer.vb", "Visual Basic", 275, 0, 0, 0, 0, 74, 5, 354
"f:\MANDARA10F\MANDARA10sourceCode10015\mandara10Ver10015\mandara2\General-Purpose-Form\frmPictureSelector.vb", "Visual Basic", 389, 0, 0, 0, 0, 0, 27, 416
"f:\MANDARA10F\MANDARA10sourceCode10015\mandara10Ver10015\mandara2\General-Purpose-Form\frmSearch_Object.Designer.vb", "Visual Basic", 232, 0, 0, 0, 0, 59, 5, 296
"f:\MANDARA10F\MANDARA10sourceCode10015\mandara10Ver10015\mandara2\General-Purpose-Form\frmSearch_Object.vb", "Visual Basic", 201, 0, 0, 0, 0, 0, 28, 229
"f:\MANDARA10F\MANDARA10sourceCode10015\mandara10Ver10015\mandara2\General-Purpose-Form\frmSelectComboBox.Designer.vb", "Visual Basic", 63, 0, 0, 0, 0, 17, 5, 85
"f:\MANDARA10F\MANDARA10sourceCode10015\mandara10Ver10015\mandara2\General-Purpose-Form\frmSelectComboBox.vb", "Visual Basic", 37, 0, 0, 0, 0, 0, 14, 51
"f:\MANDARA10F\MANDARA10sourceCode10015\mandara10Ver10015\mandara2\General-Purpose-Form\frmSelectList.Designer.vb", "Visual Basic", 62, 0, 0, 0, 0, 17, 5, 84
"f:\MANDARA10F\MANDARA10sourceCode10015\mandara10Ver10015\mandara2\General-Purpose-Form\frmSelectList.vb", "Visual Basic", 39, 0, 0, 0, 0, 0, 14, 53
"f:\MANDARA10F\MANDARA10sourceCode10015\mandara10Ver10015\mandara2\General-Purpose-Form\frmSelectListBox.Designer.vb", "Visual Basic", 77, 0, 0, 0, 0, 20, 5, 102
"f:\MANDARA10F\MANDARA10sourceCode10015\mandara10Ver10015\mandara2\General-Purpose-Form\frmSelectListBox.vb", "Visual Basic", 53, 0, 0, 0, 0, 12, 0, 65
"f:\MANDARA10F\MANDARA10sourceCode10015\mandara10Ver10015\mandara2\General-Purpose-Form\frmSelectTwoCombobox.Designer.vb", "Visual Basic", 99, 0, 0, 0, 0, 26, 5, 130
"f:\MANDARA10F\MANDARA10sourceCode10015\mandara10Ver10015\mandara2\General-Purpose-Form\frmSelectTwoCombobox.vb", "Visual Basic", 41, 0, 0, 0, 0, 0, 3, 44
"f:\MANDARA10F\MANDARA10sourceCode10015\mandara10Ver10015\mandara2\General-Purpose-Form\frmShapeFile.Designer.vb", "Visual Basic", 381, 0, 0, 0, 0, 107, 5, 493
"f:\MANDARA10F\MANDARA10sourceCode10015\mandara10Ver10015\mandara2\General-Purpose-Form\frmShapeFile.vb", "Visual Basic", 348, 0, 0, 0, 0, 5, 27, 380
"f:\MANDARA10F\MANDARA10sourceCode10015\mandara10Ver10015\mandara2\General-Purpose-Form\frmSmootingLineIn.Designer.vb", "Visual Basic", 174, 0, 0, 0, 0, 47, 5, 226
"f:\MANDARA10F\MANDARA10sourceCode10015\mandara10Ver10015\mandara2\General-Purpose-Form\frmSmootingLineIn.vb", "Visual Basic", 77, 0, 0, 0, 0, 6, 6, 89
"f:\MANDARA10F\MANDARA10sourceCode10015\mandara10Ver10015\mandara2\General-Purpose-Form\frmSyntheticObject.designer.vb", "Visual Basic", 140, 0, 0, 0, 0, 41, 5, 186
"f:\MANDARA10F\MANDARA10sourceCode10015\mandara10Ver10015\mandara2\General-Purpose-Form\frmSyntheticObject.vb", "Visual Basic", 115, 0, 0, 0, 0, 0, 8, 123
"f:\MANDARA10F\MANDARA10sourceCode10015\mandara10Ver10015\mandara2\General-Purpose-Form\frmTileMapServiceSelect.Designer.vb", "Visual Basic", 301, 0, 0, 0, 0, 77, 5, 383
"f:\MANDARA10F\MANDARA10sourceCode10015\mandara10Ver10015\mandara2\General-Purpose-Form\frmTileMapServiceSelect.vb", "Visual Basic", 206, 0, 0, 0, 0, 8, 32, 246
"f:\MANDARA10F\MANDARA10sourceCode10015\mandara10Ver10015\mandara2\General-Purpose-Form\frmTitleSettingsAddingData.Designer.vb", "Visual Basic", 109, 0, 0, 0, 0, 35, 5, 149
"f:\MANDARA10F\MANDARA10sourceCode10015\mandara10Ver10015\mandara2\General-Purpose-Form\frmTitleSettingsAddingData.vb", "Visual Basic", 44, 0, 0, 0, 0, 0, 3, 47
"f:\MANDARA10F\MANDARA10sourceCode10015\mandara10Ver10015\mandara2\General-Purpose-Form\frmUserTileMap.designer.vb", "Visual Basic", 330, 0, 0, 0, 0, 98, 5, 433
"f:\MANDARA10F\MANDARA10sourceCode10015\mandara10Ver10015\mandara2\General-Purpose-Form\frmUserTileMap.vb", "Visual Basic", 296, 0, 0, 0, 0, 0, 25, 321
"f:\MANDARA10F\MANDARA10sourceCode10015\mandara10Ver10015\mandara2\HELP\StyleSheet.css", "CSS", 0, 0, 0, 106, 0, 0, 11, 117
"f:\MANDARA10F\MANDARA10sourceCode10015\mandara10Ver10015\mandara2\HELP\about.html", "HTML", 0, 0, 121, 0, 0, 0, 9, 130
"f:\MANDARA10F\MANDARA10sourceCode10015\mandara10Ver10015\mandara2\HELP\glossary.html", "HTML", 0, 0, 104, 0, 0, 0, 9, 113
"f:\MANDARA10F\MANDARA10sourceCode10015\mandara10Ver10015\mandara2\HELP\index.html", "HTML", 0, 0, 110, 0, 0, 0, 4, 114
"f:\MANDARA10F\MANDARA10sourceCode10015\mandara10Ver10015\mandara2\HELP\mapeditor.html", "HTML", 0, 0, 1120, 0, 0, 0, 66, 1186
"f:\MANDARA10F\MANDARA10sourceCode10015\mandara10Ver10015\mandara2\HELP\outputwindow.html", "HTML", 0, 0, 567, 0, 0, 0, 21, 588
"f:\MANDARA10F\MANDARA10sourceCode10015\mandara10Ver10015\mandara2\HELP\propertydata.html", "HTML", 0, 0, 902, 0, 0, 0, 35, 937
"f:\MANDARA10F\MANDARA10sourceCode10015\mandara10Ver10015\mandara2\HELP\settingwindow.html", "HTML", 0, 0, 829, 0, 0, 0, 19, 848
"f:\MANDARA10F\MANDARA10sourceCode10015\mandara10Ver10015\mandara2\HELP\subwindow.html", "HTML", 0, 0, 202, 0, 0, 0, 10, 212
"f:\MANDARA10F\MANDARA10sourceCode10015\mandara10Ver10015\mandara2\LinePatternRelated\frmLpatBasicSelect.Designer.vb", "Visual Basic", 173, 0, 0, 0, 0, 47, 5, 225
"f:\MANDARA10F\MANDARA10sourceCode10015\mandara10Ver10015\mandara2\LinePatternRelated\frmLpatBasicSelect.vb", "Visual Basic", 215, 0, 0, 0, 0, 2, 9, 226
"f:\MANDARA10F\MANDARA10sourceCode10015\mandara10Ver10015\mandara2\LinePatternRelated\frmMakeLineBrokenPattern.Designer.vb", "Visual Basic", 96, 0, 0, 0, 0, 29, 5, 130
"f:\MANDARA10F\MANDARA10sourceCode10015\mandara10Ver10015\mandara2\LinePatternRelated\frmMakeLineBrokenPattern.vb", "Visual Basic", 155, 0, 0, 0, 0, 0, 15, 170
"f:\MANDARA10F\MANDARA10sourceCode10015\mandara10Ver10015\mandara2\LinePatternRelated\frmMakeLineCrossPattern.Designer.vb", "Visual Basic", 112, 0, 0, 0, 0, 32, 5, 149
"f:\MANDARA10F\MANDARA10sourceCode10015\mandara10Ver10015\mandara2\LinePatternRelated\frmMakeLineCrossPattern.vb", "Visual Basic", 210, 0, 0, 0, 0, 0, 8, 218
"f:\MANDARA10F\MANDARA10sourceCode10015\mandara10Ver10015\mandara2\LinePatternRelated\frmMakeLineEdgePattern.Designer.vb", "Visual Basic", 171, 0, 0, 0, 0, 44, 5, 220
"f:\MANDARA10F\MANDARA10sourceCode10015\mandara10Ver10015\mandara2\LinePatternRelated\frmMakeLineEdgePattern.vb", "Visual Basic", 49, 0, 0, 0, 0, 0, 6, 55
"f:\MANDARA10F\MANDARA10sourceCode10015\mandara10Ver10015\mandara2\LinePatternRelated\frmMakeLineParallelPattern.Designer.vb", "Visual Basic", 226, 0, 0, 0, 0, 59, 5, 290
"f:\MANDARA10F\MANDARA10sourceCode10015\mandara10Ver10015\mandara2\LinePatternRelated\frmMakeLineParallelPattern.vb", "Visual Basic", 81, 0, 0, 0, 0, 0, 11, 92
"f:\MANDARA10F\MANDARA10sourceCode10015\mandara10Ver10015\mandara2\LinePatternRelated\frmMakeLinePattern.Designer.vb", "Visual Basic", 209, 0, 0, 0, 0, 56, 5, 270
"f:\MANDARA10F\MANDARA10sourceCode10015\mandara10Ver10015\mandara2\LinePatternRelated\frmMakeLinePattern.vb", "Visual Basic", 99, 0, 0, 0, 0, 0, 15, 114
"f:\MANDARA10F\MANDARA10sourceCode10015\mandara10Ver10015\mandara2\LinePatternRelated\frmMakeLineSolidPattern.Designer.vb", "Visual Basic", 117, 0, 0, 0, 0, 32, 5, 154
"f:\MANDARA10F\MANDARA10sourceCode10015\mandara10Ver10015\mandara2\LinePatternRelated\frmMakeLineSolidPattern.vb", "Visual Basic", 34, 0, 0, 0, 0, 0, 5, 39
"f:\MANDARA10F\MANDARA10sourceCode10015\mandara10Ver10015\mandara2\My Project\Application.Designer.vb", "Visual Basic", 18, 0, 0, 0, 0, 14, 7, 39
"f:\MANDARA10F\MANDARA10sourceCode10015\mandara10Ver10015\mandara2\My Project\AssemblyInfo.vb", "Visual Basic", 13, 0, 0, 0, 0, 15, 8, 36
"f:\MANDARA10F\MANDARA10sourceCode10015\mandara10Ver10015\mandara2\My Project\Resources.Designer.vb", "Visual Basic", 32, 0, 0, 0, 0, 23, 9, 64
"f:\MANDARA10F\MANDARA10sourceCode10015\mandara10Ver10015\mandara2\My Project\Settings.Designer.vb", "Visual Basic", 51, 0, 0, 0, 0, 9, 14, 74
"f:\MANDARA10F\MANDARA10sourceCode10015\mandara10Ver10015\mandara2\Settings.vb", "Visual Basic", 4, 0, 0, 0, 0, 5, 3, 12
"f:\MANDARA10F\MANDARA10sourceCode10015\mandara10Ver10015\mandara2\TKY2JGD.vb", "Visual Basic", 334, 0, 0, 0, 0, 227, 47, 608
"f:\MANDARA10F\MANDARA10sourceCode10015\mandara10Ver10015\mandara2\bin\Release\MANDARA10.xml", "XML", 0, 10944, 0, 0, 0, 0, 2, 10946
"f:\MANDARA10F\MANDARA10sourceCode10015\mandara10Ver10015\mandara2\bin\Release\Newtonsoft.Json.xml", "XML", 0, 11262, 0, 0, 0, 0, 1, 11263
"f:\MANDARA10F\MANDARA10sourceCode10015\mandara10Ver10015\mandara2\bin\Release\help\StyleSheet.css", "CSS", 0, 0, 0, 106, 0, 0, 11, 117
"f:\MANDARA10F\MANDARA10sourceCode10015\mandara10Ver10015\mandara2\bin\Release\help\about.html", "HTML", 0, 0, 121, 0, 0, 0, 9, 130
"f:\MANDARA10F\MANDARA10sourceCode10015\mandara10Ver10015\mandara2\bin\Release\help\glossary.html", "HTML", 0, 0, 104, 0, 0, 0, 9, 113
"f:\MANDARA10F\MANDARA10sourceCode10015\mandara10Ver10015\mandara2\bin\Release\help\index.html", "HTML", 0, 0, 110, 0, 0, 0, 4, 114
"f:\MANDARA10F\MANDARA10sourceCode10015\mandara10Ver10015\mandara2\bin\Release\help\mapeditor.html", "HTML", 0, 0, 1120, 0, 0, 0, 66, 1186
"f:\MANDARA10F\MANDARA10sourceCode10015\mandara10Ver10015\mandara2\bin\Release\help\outputwindow.html", "HTML", 0, 0, 567, 0, 0, 0, 21, 588
"f:\MANDARA10F\MANDARA10sourceCode10015\mandara10Ver10015\mandara2\bin\Release\help\propertydata.html", "HTML", 0, 0, 902, 0, 0, 0, 35, 937
"f:\MANDARA10F\MANDARA10sourceCode10015\mandara10Ver10015\mandara2\bin\Release\help\settingwindow.html", "HTML", 0, 0, 829, 0, 0, 0, 19, 848
"f:\MANDARA10F\MANDARA10sourceCode10015\mandara10Ver10015\mandara2\bin\Release\help\subwindow.html", "HTML", 0, 0, 202, 0, 0, 0, 10, 212
"f:\MANDARA10F\MANDARA10sourceCode10015\mandara10Ver10015\mandara2\bin\Release\kjmapdata.js", "JavaScript", 0, 0, 0, 0, 5721, 4, 8, 5733
"f:\MANDARA10F\MANDARA10sourceCode10015\mandara10Ver10015\mandara2\bin\Release\tilemapdata.xml", "XML", 0, 1332, 0, 0, 0, 0, 1, 1333
"f:\MANDARA10F\MANDARA10sourceCode10015\mandara10Ver10015\mandara2\clsAttrData.vb", "Visual Basic", 7566, 0, 0, 0, 0, 1792, 480, 9838
"f:\MANDARA10F\MANDARA10sourceCode10015\mandara10Ver10015\mandara2\clsDraw.vb", "Visual Basic", 1081, 0, 0, 0, 0, 174, 156, 1411
"f:\MANDARA10F\MANDARA10sourceCode10015\mandara10Ver10015\mandara2\clsDrawMarkFan.vb", "Visual Basic", 312, 0, 0, 0, 0, 42, 33, 387
"f:\MANDARA10F\MANDARA10sourceCode10015\mandara10Ver10015\mandara2\clsDrawTile.vb", "Visual Basic", 331, 0, 0, 0, 0, 71, 47, 449
"f:\MANDARA10F\MANDARA10sourceCode10015\mandara10Ver10015\mandara2\clsExtendedControl.vb", "Visual Basic", 628, 0, 0, 0, 0, 149, 66, 843
"f:\MANDARA10F\MANDARA10sourceCode10015\mandara10Ver10015\mandara2\clsGeneric.vb", "Visual Basic", 4536, 0, 0, 0, 0, 1658, 317, 6511
"f:\MANDARA10F\MANDARA10sourceCode10015\mandara10Ver10015\mandara2\clsMapData.vb", "Visual Basic", 5693, 0, 0, 0, 0, 1492, 633, 7818
"f:\MANDARA10F\MANDARA10sourceCode10015\mandara10Ver10015\mandara2\clsMeshContour.vb", "Visual Basic", 556, 0, 0, 0, 0, 80, 80, 716
"f:\MANDARA10F\MANDARA10sourceCode10015\mandara10Ver10015\mandara2\clsSortingSearch.vb", "Visual Basic", 782, 0, 0, 0, 0, 333, 57, 1172
"f:\MANDARA10F\MANDARA10sourceCode10015\mandara10Ver10015\mandara2\clsSpatialIndexSearch.vb", "Visual Basic", 769, 0, 0, 0, 0, 155, 104, 1028
"f:\MANDARA10F\MANDARA10sourceCode10015\mandara10Ver10015\mandara2\frmGridRelated\frmGrid.Designer.vb", "Visual Basic", 514, 0, 0, 0, 0, 150, 5, 669
"f:\MANDARA10F\MANDARA10sourceCode10015\mandara10Ver10015\mandara2\frmGridRelated\frmGrid.vb", "Visual Basic", 2199, 0, 0, 0, 0, 102, 156, 2457
"f:\MANDARA10F\MANDARA10sourceCode10015\mandara10Ver10015\mandara2\frmGridRelated\frmGridAddDefData.designer.vb", "Visual Basic", 263, 0, 0, 0, 0, 77, 5, 345
"f:\MANDARA10F\MANDARA10sourceCode10015\mandara10Ver10015\mandara2\frmGridRelated\frmGridAddDefData.vb", "Visual Basic", 253, 0, 0, 0, 0, 15, 27, 295
"f:\MANDARA10F\MANDARA10sourceCode10015\mandara10Ver10015\mandara2\frmGridRelated\frmGridDataRefference.Designer.vb", "Visual Basic", 86, 0, 0, 0, 0, 32, 5, 123
"f:\MANDARA10F\MANDARA10sourceCode10015\mandara10Ver10015\mandara2\frmGridRelated\frmGridDataRefference.vb", "Visual Basic", 148, 0, 0, 0, 0, 0, 7, 155
"f:\MANDARA10F\MANDARA10sourceCode10015\mandara10Ver10015\mandara2\frmGridRelated\frmGridGPX.designer.vb", "Visual Basic", 178, 0, 0, 0, 0, 47, 5, 230
"f:\MANDARA10F\MANDARA10sourceCode10015\mandara10Ver10015\mandara2\frmGridRelated\frmGridGPX.vb", "Visual Basic", 85, 0, 0, 0, 0, 0, 6, 91
"f:\MANDARA10F\MANDARA10sourceCode10015\mandara10Ver10015\mandara2\frmMainRelated\clsOldMDRFile.vb", "Visual Basic", 1328, 0, 0, 0, 0, 54, 139, 1521
"f:\MANDARA10F\MANDARA10sourceCode10015\mandara10Ver10015\mandara2\frmMainRelated\frmInnerData.Designer.vb", "Visual Basic", 112, 0, 0, 0, 0, 29, 5, 146
"f:\MANDARA10F\MANDARA10sourceCode10015\mandara10Ver10015\mandara2\frmMainRelated\frmInnerData.vb", "Visual Basic", 80, 0, 0, 0, 0, 0, 7, 87
"f:\MANDARA10F\MANDARA10sourceCode10015\mandara10Ver10015\mandara2\frmMainRelated\frmMain.Designer.vb", "Visual Basic", 1340, 0, 0, 0, 0, 452, 5, 1797
"f:\MANDARA10F\MANDARA10sourceCode10015\mandara10Ver10015\mandara2\frmMainRelated\frmMain.vb", "Visual Basic", 2965, 0, 0, 0, 0, 324, 246, 3535
"f:\MANDARA10F\MANDARA10sourceCode10015\mandara10Ver10015\mandara2\frmMainRelated\frmMainProperty.Designer.vb", "Visual Basic", 82, 0, 0, 0, 0, 23, 5, 110
"f:\MANDARA10F\MANDARA10sourceCode10015\mandara10Ver10015\mandara2\frmMainRelated\frmMainProperty.vb", "Visual Basic", 36, 0, 0, 0, 0, 0, 4, 40
"f:\MANDARA10F\MANDARA10sourceCode10015\mandara10Ver10015\mandara2\frmMainRelated\frmMain_AreaPeripheri.designer.vb", "Visual Basic", 98, 0, 0, 0, 0, 26, 5, 129
"f:\MANDARA10F\MANDARA10sourceCode10015\mandara10Ver10015\mandara2\frmMainRelated\frmMain_AreaPeripheri.vb", "Visual Basic", 79, 0, 0, 0, 0, 0, 9, 88
"f:\MANDARA10F\MANDARA10sourceCode10015\mandara10Ver10015\mandara2\frmMainRelated\frmMain_Buffer.designer.vb", "Visual Basic", 288, 0, 0, 0, 0, 80, 5, 373
"f:\MANDARA10F\MANDARA10sourceCode10015\mandara10Ver10015\mandara2\frmMainRelated\frmMain_Buffer.vb", "Visual Basic", 498, 0, 0, 0, 0, 32, 37, 567
"f:\MANDARA10F\MANDARA10sourceCode10015\mandara10Ver10015\mandara2\frmMainRelated\frmMain_ClassViewSettings.Designer.vb", "Visual Basic", 425, 0, 0, 0, 0, 125, 5, 555
"f:\MANDARA10F\MANDARA10sourceCode10015\mandara10Ver10015\mandara2\frmMainRelated\frmMain_ClassViewSettings.vb", "Visual Basic", 1050, 0, 0, 0, 0, 61, 70, 1181
"f:\MANDARA10F\MANDARA10sourceCode10015\mandara10Ver10015\mandara2\frmMainRelated\frmMain_ConditionSettingSub.Designer.vb", "Visual Basic", 383, 0, 0, 0, 0, 110, 5, 498
"f:\MANDARA10F\MANDARA10sourceCode10015\mandara10Ver10015\mandara2\frmMainRelated\frmMain_ConditionSettingSub.vb", "Visual Basic", 217, 0, 0, 0, 0, 0, 14, 231
"f:\MANDARA10F\MANDARA10sourceCode10015\mandara10Ver10015\mandara2\frmMainRelated\frmMain_ConditionSettings.Designer.vb", "Visual Basic", 123, 0, 0, 0, 0, 38, 5, 166
"f:\MANDARA10F\MANDARA10sourceCode10015\mandara10Ver10015\mandara2\frmMainRelated\frmMain_ConditionSettings.vb", "Visual Basic", 103, 0, 0, 0, 0, 0, 14, 117
"f:\MANDARA10F\MANDARA10sourceCode10015\mandara10Ver10015\mandara2\frmMainRelated\frmMain_ContourViewSettings.Designer.vb", "Visual Basic", 629, 0, 0, 0, 0, 155, 5, 789
"f:\MANDARA10F\MANDARA10sourceCode10015\mandara10Ver10015\mandara2\frmMainRelated\frmMain_ContourViewSettings.vb", "Visual Basic", 286, 0, 0, 0, 0, 0, 40, 326
"f:\MANDARA10F\MANDARA10sourceCode10015\mandara10Ver10015\mandara2\frmMainRelated\frmMain_CopyDataItemSettings.Designer.vb", "Visual Basic", 229, 0, 0, 0, 0, 62, 5, 296
"f:\MANDARA10F\MANDARA10sourceCode10015\mandara10Ver10015\mandara2\frmMainRelated\frmMain_CopyDataItemSettings.vb", "Visual Basic", 81, 0, 0, 0, 0, 0, 15, 96
"f:\MANDARA10F\MANDARA10sourceCode10015\mandara10Ver10015\mandara2\frmMainRelated\frmMain_Cross.designer.vb", "Visual Basic", 395, 0, 0, 0, 0, 110, 5, 510
"f:\MANDARA10F\MANDARA10sourceCode10015\mandara10Ver10015\mandara2\frmMainRelated\frmMain_Cross.vb", "Visual Basic", 611, 0, 0, 0, 0, 3, 49, 663
"f:\MANDARA10F\MANDARA10sourceCode10015\mandara10Ver10015\mandara2\frmMainRelated\frmMain_Culc.designer.vb", "Visual Basic", 397, 0, 0, 0, 0, 101, 5, 503
"f:\MANDARA10F\MANDARA10sourceCode10015\mandara10Ver10015\mandara2\frmMainRelated\frmMain_Culc.vb", "Visual Basic", 362, 0, 0, 0, 0, 10, 34, 406
"f:\MANDARA10F\MANDARA10sourceCode10015\mandara10Ver10015\mandara2\frmMainRelated\frmMain_ExchangeObjectName.designer.vb", "Visual Basic", 107, 0, 0, 0, 0, 29, 5, 141
"f:\MANDARA10F\MANDARA10sourceCode10015\mandara10Ver10015\mandara2\frmMainRelated\frmMain_ExchangeObjectName.vb", "Visual Basic", 55, 0, 0, 0, 0, 0, 6, 61
"f:\MANDARA10F\MANDARA10sourceCode10015\mandara10Ver10015\mandara2\frmMainRelated\frmMain_GetDistance.designer.vb", "Visual Basic", 173, 0, 0, 0, 0, 50, 5, 228
"f:\MANDARA10F\MANDARA10sourceCode10015\mandara10Ver10015\mandara2\frmMainRelated\frmMain_GetDistance.vb", "Visual Basic", 221, 0, 0, 0, 0, 3, 19, 243
"f:\MANDARA10F\MANDARA10sourceCode10015\mandara10Ver10015\mandara2\frmMainRelated\frmMain_GraphModeSettings.Designer.vb", "Visual Basic", 798, 0, 0, 0, 0, 197, 5, 1000
"f:\MANDARA10F\MANDARA10sourceCode10015\mandara10Ver10015\mandara2\frmMainRelated\frmMain_GraphModeSettings.vb", "Visual Basic", 805, 0, 0, 0, 0, 15, 68, 888
"f:\MANDARA10F\MANDARA10sourceCode10015\mandara10Ver10015\mandara2\frmMainRelated\frmMain_LabelModeSettings.Designer.vb", "Visual Basic", 500, 0, 0, 0, 0, 134, 5, 639
"f:\MANDARA10F\MANDARA10sourceCode10015\mandara10Ver10015\mandara2\frmMainRelated\frmMain_LabelModeSettings.vb", "Visual Basic", 305, 0, 0, 0, 0, 2, 36, 343
"f:\MANDARA10F\MANDARA10sourceCode10015\mandara10Ver10015\mandara2\frmMainRelated\frmMain_LayeObjectSelect.Designer.vb", "Visual Basic", 83, 0, 0, 0, 0, 23, 5, 111
"f:\MANDARA10F\MANDARA10sourceCode10015\mandara10Ver10015\mandara2\frmMainRelated\frmMain_LayeObjectSelect.vb", "Visual Basic", 69, 0, 0, 0, 0, 0, 5, 74
"f:\MANDARA10F\MANDARA10sourceCode10015\mandara10Ver10015\mandara2\frmMainRelated\frmMain_LayerObjectCombine.designer.vb", "Visual Basic", 121, 0, 0, 0, 0, 35, 5, 161
"f:\MANDARA10F\MANDARA10sourceCode10015\mandara10Ver10015\mandara2\frmMainRelated\frmMain_LayerObjectCombine.vb", "Visual Basic", 264, 0, 0, 0, 0, 8, 24, 296
"f:\MANDARA10F\MANDARA10sourceCode10015\mandara10Ver10015\mandara2\frmMainRelated\frmMain_MarkViewSettings.Designer.vb", "Visual Basic", 1027, 0, 0, 0, 0, 266, 5, 1298
"f:\MANDARA10F\MANDARA10sourceCode10015\mandara10Ver10015\mandara2\frmMainRelated\frmMain_MarkViewSettings.vb", "Visual Basic", 463, 0, 0, 0, 0, 5, 55, 523
"f:\MANDARA10F\MANDARA10sourceCode10015\mandara10Ver10015\mandara2\frmMainRelated\frmMain_ObjectLimitaion.designer.vb", "Visual Basic", 122, 0, 0, 0, 0, 32, 5, 159
"f:\MANDARA10F\MANDARA10sourceCode10015\mandara10Ver10015\mandara2\frmMainRelated\frmMain_ObjectLimitaion.vb", "Visual Basic", 99, 0, 0, 0, 0, 0, 12, 111
"f:\MANDARA10F\MANDARA10sourceCode10015\mandara10Ver10015\mandara2\frmMainRelated\frmMain_OverLayModeSettings.Designer.vb", "Visual Basic", 249, 0, 0, 0, 0, 68, 5, 322
"f:\MANDARA10F\MANDARA10sourceCode10015\mandara10Ver10015\mandara2\frmMainRelated\frmMain_OverLayModeSettings.vb", "Visual Basic", 337, 0, 0, 0, 0, 0, 29, 366
"f:\MANDARA10F\MANDARA10sourceCode10015\mandara10Ver10015\mandara2\frmMainRelated\frmMain_PainrColor.designer.vb", "Visual Basic", 53, 0, 0, 0, 0, 14, 5, 72
"f:\MANDARA10F\MANDARA10sourceCode10015\mandara10Ver10015\mandara2\frmMainRelated\frmMain_PainrColor.vb", "Visual Basic", 141, 0, 0, 0, 0, 0, 11, 152
"f:\MANDARA10F\MANDARA10sourceCode10015\mandara10Ver10015\mandara2\frmMainRelated\frmMain_SelMapObject.designer.vb", "Visual Basic", 213, 0, 0, 0, 0, 56, 5, 274
"f:\MANDARA10F\MANDARA10sourceCode10015\mandara10Ver10015\mandara2\frmMainRelated\frmMain_SelMapObject.vb", "Visual Basic", 151, 0, 0, 0, 0, 0, 13, 164
"f:\MANDARA10F\MANDARA10sourceCode10015\mandara10Ver10015\mandara2\frmMainRelated\frmMain_SeriesModeSettings.Designer.vb", "Visual Basic", 196, 0, 0, 0, 0, 53, 5, 254
"f:\MANDARA10F\MANDARA10sourceCode10015\mandara10Ver10015\mandara2\frmMainRelated\frmMain_SeriesModeSettings.vb", "Visual Basic", 186, 0, 0, 0, 0, 0, 22, 208
"f:\MANDARA10F\MANDARA10sourceCode10015\mandara10Ver10015\mandara2\frmMainRelated\frmMain_SetPositionFromData.designer.vb", "Visual Basic", 104, 0, 0, 0, 0, 29, 5, 138
"f:\MANDARA10F\MANDARA10sourceCode10015\mandara10Ver10015\mandara2\frmMainRelated\frmMain_SetPositionFromData.vb", "Visual Basic", 114, 0, 0, 0, 0, 0, 8, 122
"f:\MANDARA10F\MANDARA10sourceCode10015\mandara10Ver10015\mandara2\frmMainRelated\frmMain_SetSeriesMode.Designer.vb", "Visual Basic", 461, 0, 0, 0, 0, 128, 5, 594
"f:\MANDARA10F\MANDARA10sourceCode10015\mandara10Ver10015\mandara2\frmMainRelated\frmMain_SetSeriesMode.vb", "Visual Basic", 269, 0, 0, 0, 0, 6, 16, 291
"f:\MANDARA10F\MANDARA10sourceCode10015\mandara10Ver10015\mandara2\frmMainRelated\frmMain_ShapefileOut.designer.vb", "Visual Basic", 114, 0, 0, 0, 0, 29, 5, 148
"f:\MANDARA10F\MANDARA10sourceCode10015\mandara10Ver10015\mandara2\frmMainRelated\frmMain_ShapefileOut.vb", "Visual Basic", 116, 0, 0, 0, 0, 0, 17, 133
"f:\MANDARA10F\MANDARA10sourceCode10015\mandara10Ver10015\mandara2\frmMainRelated\frmMain_ShowViewer.Designer.vb", "Visual Basic", 214, 0, 0, 0, 0, 65, 5, 284
"f:\MANDARA10F\MANDARA10sourceCode10015\mandara10Ver10015\mandara2\frmMainRelated\frmMain_ShowViewer.vb", "Visual Basic", 264, 0, 0, 0, 0, 0, 24, 288
"f:\MANDARA10F\MANDARA10sourceCode10015\mandara10Ver10015\mandara2\frmMainRelated\frmMain_TimeSeriesSummingUp.designer.vb", "Visual Basic", 97, 0, 0, 0, 0, 29, 5, 131
"f:\MANDARA10F\MANDARA10sourceCode10015\mandara10Ver10015\mandara2\frmMainRelated\frmMain_TimeSeriesSummingUp.vb", "Visual Basic", 464, 0, 0, 0, 0, 37, 53, 554
"f:\MANDARA10F\MANDARA10sourceCode10015\mandara10Ver10015\mandara2\frmMainRelated\frmMain_TripModeSettings.Designer.vb", "Visual Basic", 433, 0, 0, 0, 0, 110, 5, 548
"f:\MANDARA10F\MANDARA10sourceCode10015\mandara10Ver10015\mandara2\frmMainRelated\frmMain_TripModeSettings.vb", "Visual Basic", 288, 0, 0, 0, 0, 0, 37, 325
"f:\MANDARA10F\MANDARA10sourceCode10015\mandara10Ver10015\mandara2\frmMainRelated\frmShowDataItems.Designer.vb", "Visual Basic", 53, 0, 0, 0, 0, 11, 5, 69
"f:\MANDARA10F\MANDARA10sourceCode10015\mandara10Ver10015\mandara2\frmMainRelated\frmShowDataItems.vb", "Visual Basic", 56, 0, 0, 0, 0, 0, 1, 57
"f:\MANDARA10F\MANDARA10sourceCode10015\mandara10Ver10015\mandara2\frmMainRelated\frmStartUp.designer.vb", "Visual Basic", 188, 0, 0, 0, 0, 53, 5, 246
"f:\MANDARA10F\MANDARA10sourceCode10015\mandara10Ver10015\mandara2\frmMainRelated\frmStartUp.vb", "Visual Basic", 103, 0, 0, 0, 0, 2, 16, 121
"f:\MANDARA10F\MANDARA10sourceCode10015\mandara10Ver10015\mandara2\frmMainRelated\frmUseClassSettings.Designer.vb", "Visual Basic", 119, 0, 0, 0, 0, 35, 5, 159
"f:\MANDARA10F\MANDARA10sourceCode10015\mandara10Ver10015\mandara2\frmMainRelated\frmUseClassSettings.vb", "Visual Basic", 143, 0, 0, 0, 0, 0, 9, 152
"f:\MANDARA10F\MANDARA10sourceCode10015\mandara10Ver10015\mandara2\frmMainRelated\frmVersionInfo.designer.vb", "Visual Basic", 117, 0, 0, 0, 0, 32, 5, 154
"f:\MANDARA10F\MANDARA10sourceCode10015\mandara10Ver10015\mandara2\frmMainRelated\frmVersionInfo.vb", "Visual Basic", 50, 0, 0, 0, 0, 0, 11, 61
"f:\MANDARA10F\MANDARA10sourceCode10015\mandara10Ver10015\mandara2\frmMapEditorRelated\clsE00.vb", "Visual Basic", 500, 0, 0, 0, 0, 21, 44, 565
"f:\MANDARA10F\MANDARA10sourceCode10015\mandara10Ver10015\mandara2\frmMapEditorRelated\clsKiban.vb", "Visual Basic", 376, 0, 0, 0, 0, 11, 8, 395
"f:\MANDARA10F\MANDARA10sourceCode10015\mandara10Ver10015\mandara2\frmMapEditorRelated\clsMED_Undo.vb", "Visual Basic", 941, 0, 0, 0, 0, 82, 18, 1041
"f:\MANDARA10F\MANDARA10sourceCode10015\mandara10Ver10015\mandara2\frmMapEditorRelated\clsMapEditorOperation.vb", "Visual Basic", 5677, 0, 0, 0, 0, 1000, 439, 7116
"f:\MANDARA10F\MANDARA10sourceCode10015\mandara10Ver10015\mandara2\frmMapEditorRelated\clsOSM.vb", "Visual Basic", 319, 0, 0, 0, 0, 4, 19, 342
"f:\MANDARA10F\MANDARA10sourceCode10015\mandara10Ver10015\mandara2\frmMapEditorRelated\clsOldMapFile.vb", "Visual Basic", 755, 0, 0, 0, 0, 28, 53, 836
"f:\MANDARA10F\MANDARA10sourceCode10015\mandara10Ver10015\mandara2\frmMapEditorRelated\frmMED_AggrObjClipSet.Designer.vb", "Visual Basic", 134, 0, 0, 0, 0, 32, 5, 171
"f:\MANDARA10F\MANDARA10sourceCode10015\mandara10Ver10015\mandara2\frmMapEditorRelated\frmMED_AggrObjClipSet.vb", "Visual Basic", 200, 0, 0, 0, 0, 1, 16, 217
"f:\MANDARA10F\MANDARA10sourceCode10015\mandara10Ver10015\mandara2\frmMapEditorRelated\frmMED_AggrObjSet.Designer.vb", "Visual Basic", 124, 0, 0, 0, 0, 35, 5, 164
"f:\MANDARA10F\MANDARA10sourceCode10015\mandara10Ver10015\mandara2\frmMapEditorRelated\frmMED_AggrObjSet.vb", "Visual Basic", 90, 0, 0, 0, 0, 7, 14, 111
"f:\MANDARA10F\MANDARA10sourceCode10015\mandara10Ver10015\mandara2\frmMapEditorRelated\frmMED_AggrObjUseTime.Designer.vb", "Visual Basic", 207, 0, 0, 0, 0, 62, 5, 274
"f:\MANDARA10F\MANDARA10sourceCode10015\mandara10Ver10015\mandara2\frmMapEditorRelated\frmMED_AggrObjUseTime.vb", "Visual Basic", 208, 0, 0, 0, 0, 13, 39, 260
"f:\MANDARA10F\MANDARA10sourceCode10015\mandara10Ver10015\mandara2\frmMapEditorRelated\frmMED_CensusGISData.designer.vb", "Visual Basic", 237, 0, 0, 0, 0, 65, 5, 307
"f:\MANDARA10F\MANDARA10sourceCode10015\mandara10Ver10015\mandara2\frmMapEditorRelated\frmMED_CensusGISData.vb", "Visual Basic", 566, 0, 0, 0, 0, 32, 34, 632
"f:\MANDARA10F\MANDARA10sourceCode10015\mandara10Ver10015\mandara2\frmMapEditorRelated\frmMED_CenterPointSet.Designer.vb", "Visual Basic", 158, 0, 0, 0, 0, 38, 5, 201
"f:\MANDARA10F\MANDARA10sourceCode10015\mandara10Ver10015\mandara2\frmMapEditorRelated\frmMED_CenterPointSet.vb", "Visual Basic", 147, 0, 0, 0, 0, 1, 25, 173
"f:\MANDARA10F\MANDARA10sourceCode10015\mandara10Ver10015\mandara2\frmMapEditorRelated\frmMED_ChangeAllObjectName.designer.vb", "Visual Basic", 128, 0, 0, 0, 0, 32, 5, 165
"f:\MANDARA10F\MANDARA10sourceCode10015\mandara10Ver10015\mandara2\frmMapEditorRelated\frmMED_ChangeAllObjectName.vb", "Visual Basic", 130, 0, 0, 0, 0, 6, 13, 149
"f:\MANDARA10F\MANDARA10sourceCode10015\mandara10Ver10015\mandara2\frmMapEditorRelated\frmMED_ChangeLineKind_in_MultiLineNoTime.Designer.vb", "Visual Basic", 67, 0, 0, 0, 0, 17, 5, 89
"f:\MANDARA10F\MANDARA10sourceCode10015\mandara10Ver10015\mandara2\frmMapEditorRelated\frmMED_ChangeLineKind_in_MultiLineNoTime.vb", "Visual Basic", 15, 0, 0, 0, 0, 0, 1, 16
"f:\MANDARA10F\MANDARA10sourceCode10015\mandara10Ver10015\mandara2\frmMapEditorRelated\frmMED_ChengeLineKind_in_Multiobject.Designer.vb", "Visual Basic", 82, 0, 0, 0, 0, 20, 5, 107
"f:\MANDARA10F\MANDARA10sourceCode10015\mandara10Ver10015\mandara2\frmMapEditorRelated\frmMED_ChengeLineKind_in_Multiobject.vb", "Visual Basic", 17, 0, 0, 0, 0, 0, 3, 20
"f:\MANDARA10F\MANDARA10sourceCode10015\mandara10Ver10015\mandara2\frmMapEditorRelated\frmMED_ClickSetObjName.Designer.vb", "Visual Basic", 84, 0, 0, 0, 0, 23, 5, 112
"f:\MANDARA10F\MANDARA10sourceCode10015\mandara10Ver10015\mandara2\frmMapEditorRelated\frmMED_ClickSetObjName.vb", "Visual Basic", 39, 0, 0, 0, 0, 0, 6, 45
"f:\MANDARA10F\MANDARA10sourceCode10015\mandara10Ver10015\mandara2\frmMapEditorRelated\frmMED_DefAttData.Designer.vb", "Visual Basic", 199, 0, 0, 0, 0, 56, 5, 260
"f:\MANDARA10F\MANDARA10sourceCode10015\mandara10Ver10015\mandara2\frmMapEditorRelated\frmMED_DefAttData.vb", "Visual Basic", 326, 0, 0, 0, 0, 10, 46, 382
"f:\MANDARA10F\MANDARA10sourceCode10015\mandara10Ver10015\mandara2\frmMapEditorRelated\frmMED_DefAttShow.Designer.vb", "Visual Basic", 198, 0, 0, 0, 0, 53, 5, 256
"f:\MANDARA10F\MANDARA10sourceCode10015\mandara10Ver10015\mandara2\frmMapEditorRelated\frmMED_DefAttShow.vb", "Visual Basic", 67, 0, 0, 0, 0, 0, 7, 74
"f:\MANDARA10F\MANDARA10sourceCode10015\mandara10Ver10015\mandara2\frmMapEditorRelated\frmMED_DefTimeAttData.Designer.vb", "Visual Basic", 271, 0, 0, 0, 0, 92, 5, 368
"f:\MANDARA10F\MANDARA10sourceCode10015\mandara10Ver10015\mandara2\frmMapEditorRelated\frmMED_DefTimeAttData.vb", "Visual Basic", 692, 0, 0, 0, 0, 89, 51, 832
"f:\MANDARA10F\MANDARA10sourceCode10015\mandara10Ver10015\mandara2\frmMapEditorRelated\frmMED_DefTimeAttDataItem.Designer.vb", "Visual Basic", 180, 0, 0, 0, 0, 56, 5, 241
"f:\MANDARA10F\MANDARA10sourceCode10015\mandara10Ver10015\mandara2\frmMapEditorRelated\frmMED_DefTimeAttDataItem.vb", "Visual Basic", 85, 0, 0, 0, 0, 0, 5, 90
"f:\MANDARA10F\MANDARA10sourceCode10015\mandara10Ver10015\mandara2\frmMapEditorRelated\frmMED_DefTimeAttDataObjectEdit.Designer.vb", "Visual Basic", 246, 0, 0, 0, 0, 77, 5, 328
"f:\MANDARA10F\MANDARA10sourceCode10015\mandara10Ver10015\mandara2\frmMapEditorRelated\frmMED_DefTimeAttDataObjectEdit.vb", "Visual Basic", 312, 0, 0, 0, 0, 1, 34, 347
"f:\MANDARA10F\MANDARA10sourceCode10015\mandara10Ver10015\mandara2\frmMapEditorRelated\frmMED_DefTimeAttData_ValueSet.Designer.vb", "Visual Basic", 173, 0, 0, 0, 0, 47, 5, 225
"f:\MANDARA10F\MANDARA10sourceCode10015\mandara10Ver10015\mandara2\frmMapEditorRelated\frmMED_DefTimeAttData_ValueSet.vb", "Visual Basic", 248, 0, 0, 0, 0, 3, 14, 265
"f:\MANDARA10F\MANDARA10sourceCode10015\mandara10Ver10015\mandara2\frmMapEditorRelated\frmMED_E00File.designer.vb", "Visual Basic", 264, 0, 0, 0, 0, 74, 5, 343
"f:\MANDARA10F\MANDARA10sourceCode10015\mandara10Ver10015\mandara2\frmMapEditorRelated\frmMED_E00File.vb", "Visual Basic", 236, 0, 0, 0, 0, 4, 19, 259
"f:\MANDARA10F\MANDARA10sourceCode10015\mandara10Ver10015\mandara2\frmMapEditorRelated\frmMED_GetLine.Designer.vb", "Visual Basic", 213, 0, 0, 0, 0, 53, 5, 271
"f:\MANDARA10F\MANDARA10sourceCode10015\mandara10Ver10015\mandara2\frmMapEditorRelated\frmMED_GetLine.vb", "Visual Basic", 177, 0, 0, 0, 0, 0, 23, 200
"f:\MANDARA10F\MANDARA10sourceCode10015\mandara10Ver10015\mandara2\frmMapEditorRelated\frmMED_GetPointObject.Designer.vb", "Visual Basic", 215, 0, 0, 0, 0, 53, 5, 273
"f:\MANDARA10F\MANDARA10sourceCode10015\mandara10Ver10015\mandara2\frmMapEditorRelated\frmMED_GetPointObject.vb", "Visual Basic", 168, 0, 0, 0, 0, 0, 25, 193
"f:\MANDARA10F\MANDARA10sourceCode10015\mandara10Ver10015\mandara2\frmMapEditorRelated\frmMED_Kiban.designer.vb", "Visual Basic", 135, 0, 0, 0, 0, 38, 5, 178
"f:\MANDARA10F\MANDARA10sourceCode10015\mandara10Ver10015\mandara2\frmMapEditorRelated\frmMED_Kiban.vb", "Visual Basic", 122, 0, 0, 0, 0, 5, 13, 140
"f:\MANDARA10F\MANDARA10sourceCode10015\mandara10Ver10015\mandara2\frmMapEditorRelated\frmMED_LatLonInput.Designer.vb", "Visual Basic", 134, 0, 0, 0, 0, 35, 5, 174
"f:\MANDARA10F\MANDARA10sourceCode10015\mandara10Ver10015\mandara2\frmMapEditorRelated\frmMED_LatLonInput.vb", "Visual Basic", 57, 0, 0, 0, 0, 9, 2, 68
"f:\MANDARA10F\MANDARA10sourceCode10015\mandara10Ver10015\mandara2\frmMapEditorRelated\frmMED_LineCodeTime.Designer.vb", "Visual Basic", 236, 0, 0, 0, 0, 71, 5, 312
"f:\MANDARA10F\MANDARA10sourceCode10015\mandara10Ver10015\mandara2\frmMapEditorRelated\frmMED_LineCodeTime.vb", "Visual Basic", 222, 0, 0, 0, 0, 3, 36, 261
"f:\MANDARA10F\MANDARA10sourceCode10015\mandara10Ver10015\mandara2\frmMapEditorRelated\frmMED_LineKind.Designer.vb", "Visual Basic", 304, 0, 0, 0, 0, 83, 5, 392
"f:\MANDARA10F\MANDARA10sourceCode10015\mandara10Ver10015\mandara2\frmMapEditorRelated\frmMED_LineKind.vb", "Visual Basic", 288, 0, 0, 0, 0, 0, 52, 340
"f:\MANDARA10F\MANDARA10sourceCode10015\mandara10Ver10015\mandara2\frmMapEditorRelated\frmMED_LineKindCombine.Designer.vb", "Visual Basic", 115, 0, 0, 0, 0, 32, 5, 152
"f:\MANDARA10F\MANDARA10sourceCode10015\mandara10Ver10015\mandara2\frmMapEditorRelated\frmMED_LineKindCombine.vb", "Visual Basic", 87, 0, 0, 0, 0, 0, 15, 102
"f:\MANDARA10F\MANDARA10sourceCode10015\mandara10Ver10015\mandara2\frmMapEditorRelated\frmMED_LineKindTimeSet.Designer.vb", "Visual Basic", 189, 0, 0, 0, 0, 56, 5, 250
"f:\MANDARA10F\MANDARA10sourceCode10015\mandara10Ver10015\mandara2\frmMapEditorRelated\frmMED_LineKindTimeSet.vb", "Visual Basic", 174, 0, 0, 0, 0, 0, 21, 195
"f:\MANDARA10F\MANDARA10sourceCode10015\mandara10Ver10015\mandara2\frmMapEditorRelated\frmMED_MeshContour.Designer.vb", "Visual Basic", 219, 0, 0, 0, 0, 59, 5, 283
"f:\MANDARA10F\MANDARA10sourceCode10015\mandara10Ver10015\mandara2\frmMapEditorRelated\frmMED_MeshContour.vb", "Visual Basic", 1575, 0, 0, 0, 0, 119, 141, 1835
"f:\MANDARA10F\MANDARA10sourceCode10015\mandara10Ver10015\mandara2\frmMapEditorRelated\frmMED_MultiObjDefAttr.Designer.vb", "Visual Basic", 96, 0, 0, 0, 0, 26, 5, 127
"f:\MANDARA10F\MANDARA10sourceCode10015\mandara10Ver10015\mandara2\frmMapEditorRelated\frmMED_MultiObjDefAttr.vb", "Visual Basic", 169, 0, 0, 0, 0, 40, 18, 227
"f:\MANDARA10F\MANDARA10sourceCode10015\mandara10Ver10015\mandara2\frmMapEditorRelated\frmMED_ObjectCPTimeSet.Designer.vb", "Visual Basic", 137, 0, 0, 0, 0, 41, 5, 183
"f:\MANDARA10F\MANDARA10sourceCode10015\mandara10Ver10015\mandara2\frmMapEditorRelated\frmMED_ObjectCPTimeSet.vb", "Visual Basic", 140, 0, 0, 0, 0, 0, 17, 157
"f:\MANDARA10F\MANDARA10sourceCode10015\mandara10Ver10015\mandara2\frmMapEditorRelated\frmMED_ObjectKind.Designer.vb", "Visual Basic", 315, 0, 0, 0, 0, 83, 5, 403
"f:\MANDARA10F\MANDARA10sourceCode10015\mandara10Ver10015\mandara2\frmMapEditorRelated\frmMED_ObjectKind.vb", "Visual Basic", 357, 0, 0, 0, 0, 0, 50, 407
"f:\MANDARA10F\MANDARA10sourceCode10015\mandara10Ver10015\mandara2\frmMapEditorRelated\frmMED_ObjectKindCombine.Designer.vb", "Visual Basic", 92, 0, 0, 0, 0, 26, 5, 123
"f:\MANDARA10F\MANDARA10sourceCode10015\mandara10Ver10015\mandara2\frmMapEditorRelated\frmMED_ObjectKindCombine.vb", "Visual Basic", 78, 0, 0, 0, 0, 0, 12, 90
"f:\MANDARA10F\MANDARA10sourceCode10015\mandara10Ver10015\mandara2\frmMapEditorRelated\frmMED_ObjectNameAddFromAttrData.designer.vb", "Visual Basic", 105, 0, 0, 0, 0, 26, 5, 136
"f:\MANDARA10F\MANDARA10sourceCode10015\mandara10Ver10015\mandara2\frmMapEditorRelated\frmMED_ObjectNameAddFromAttrData.vb", "Visual Basic", 55, 0, 0, 0, 0, 0, 9, 64
"f:\MANDARA10F\MANDARA10sourceCode10015\mandara10Ver10015\mandara2\frmMapEditorRelated\frmMED_ObjectNameEdit.designer.vb", "Visual Basic", 169, 0, 0, 0, 0, 47, 5, 221
"f:\MANDARA10F\MANDARA10sourceCode10015\mandara10Ver10015\mandara2\frmMapEditorRelated\frmMED_ObjectNameEdit.vb", "Visual Basic", 122, 0, 0, 0, 0, 0, 12, 134
"f:\MANDARA10F\MANDARA10sourceCode10015\mandara10Ver10015\mandara2\frmMapEditorRelated\frmMED_ObjectNameTimeSet.Designer.vb", "Visual Basic", 206, 0, 0, 0, 0, 53, 5, 264
"f:\MANDARA10F\MANDARA10sourceCode10015\mandara10Ver10015\mandara2\frmMapEditorRelated\frmMED_ObjectNameTimeSet.vb", "Visual Basic", 201, 0, 0, 0, 0, 12, 24, 237
"f:\MANDARA10F\MANDARA10sourceCode10015\mandara10Ver10015\mandara2\frmMapEditorRelated\frmMED_ObjectSuccession.Designer.vb", "Visual Basic", 206, 0, 0, 0, 0, 62, 5, 273
"f:\MANDARA10F\MANDARA10sourceCode10015\mandara10Ver10015\mandara2\frmMapEditorRelated\frmMED_ObjectSuccession.vb", "Visual Basic", 345, 0, 0, 0, 0, 7, 50, 402
"f:\MANDARA10F\MANDARA10sourceCode10015\mandara10Ver10015\mandara2\frmMapEditorRelated\frmMED_ObjectTimeNameEdit.designer.vb", "Visual Basic", 155, 0, 0, 0, 0, 44, 5, 204
"f:\MANDARA10F\MANDARA10sourceCode10015\mandara10Ver10015\mandara2\frmMapEditorRelated\frmMED_ObjectTimeNameEdit.vb", "Visual Basic", 161, 0, 0, 0, 0, 12, 15, 188
"f:\MANDARA10F\MANDARA10sourceCode10015\mandara10Ver10015\mandara2\frmMapEditorRelated\frmMED_ObjectTimeNameList.designer.vb", "Visual Basic", 147, 0, 0, 0, 0, 44, 5, 196
"f:\MANDARA10F\MANDARA10sourceCode10015\mandara10Ver10015\mandara2\frmMapEditorRelated\frmMED_ObjectTimeNameList.vb", "Visual Basic", 121, 0, 0, 0, 0, 7, 11, 139
"f:\MANDARA10F\MANDARA10sourceCode10015\mandara10Ver10015\mandara2\frmMapEditorRelated\frmMED_Preview.Designer.vb", "Visual Basic", 135, 0, 0, 0, 0, 41, 5, 181
"f:\MANDARA10F\MANDARA10sourceCode10015\mandara10Ver10015\mandara2\frmMapEditorRelated\frmMED_Preview.vb", "Visual Basic", 281, 0, 0, 0, 0, 21, 39, 341
"f:\MANDARA10F\MANDARA10sourceCode10015\mandara10Ver10015\mandara2\frmMapEditorRelated\frmMED_Property_of_MapFile.Designer.vb", "Visual Basic", 140, 0, 0, 0, 0, 38, 5, 183
"f:\MANDARA10F\MANDARA10sourceCode10015\mandara10Ver10015\mandara2\frmMapEditorRelated\frmMED_Property_of_MapFile.vb", "Visual Basic", 73, 0, 0, 0, 0, 0, 8, 81
"f:\MANDARA10F\MANDARA10sourceCode10015\mandara10Ver10015\mandara2\frmMapEditorRelated\frmMED_ReplaceObjectName.Designer.vb", "Visual Basic", 153, 0, 0, 0, 0, 44, 5, 202
"f:\MANDARA10F\MANDARA10sourceCode10015\mandara10Ver10015\mandara2\frmMapEditorRelated\frmMED_ReplaceObjectName.vb", "Visual Basic", 118, 0, 0, 0, 0, 6, 16, 140
"f:\MANDARA10F\MANDARA10sourceCode10015\mandara10Ver10015\mandara2\frmMapEditorRelated\frmMED_SRTM30Divide.designer.vb", "Visual Basic", 125, 0, 0, 0, 0, 35, 5, 165
"f:\MANDARA10F\MANDARA10sourceCode10015\mandara10Ver10015\mandara2\frmMapEditorRelated\frmMED_SRTM30Divide.vb", "Visual Basic", 155, 0, 0, 0, 0, 1, 12, 168
"f:\MANDARA10F\MANDARA10sourceCode10015\mandara10Ver10015\mandara2\frmMapEditorRelated\frmMED_ShapefileOut.Designer.vb", "Visual Basic", 137, 0, 0, 0, 0, 35, 5, 177
"f:\MANDARA10F\MANDARA10sourceCode10015\mandara10Ver10015\mandara2\frmMapEditorRelated\frmMED_ShapefileOut.vb", "Visual Basic", 106, 0, 0, 0, 0, 0, 16, 122
"f:\MANDARA10F\MANDARA10sourceCode10015\mandara10Ver10015\mandara2\frmMapEditorRelated\frmMED_Show_Object_Time_Series.Designer.vb", "Visual Basic", 200, 0, 0, 0, 0, 65, 5, 270
"f:\MANDARA10F\MANDARA10sourceCode10015\mandara10Ver10015\mandara2\frmMapEditorRelated\frmMED_Show_Object_Time_Series.vb", "Visual Basic", 348, 0, 0, 0, 0, 13, 54, 415
"f:\MANDARA10F\MANDARA10sourceCode10015\mandara10Ver10015\mandara2\frmMapEditorRelated\frmMED_TImeObjectSet.designer.vb", "Visual Basic", 98, 0, 0, 0, 0, 23, 5, 126
"f:\MANDARA10F\MANDARA10sourceCode10015\mandara10Ver10015\mandara2\frmMapEditorRelated\frmMED_TImeObjectSet.vb", "Visual Basic", 737, 0, 0, 0, 0, 133, 46, 916
"f:\MANDARA10F\MANDARA10sourceCode10015\mandara10Ver10015\mandara2\frmMapEditorRelated\frmMED_TimeObjectCombine.Designer.vb", "Visual Basic", 207, 0, 0, 0, 0, 53, 5, 265
"f:\MANDARA10F\MANDARA10sourceCode10015\mandara10Ver10015\mandara2\frmMapEditorRelated\frmMED_TimeObjectCombine.vb", "Visual Basic", 92, 0, 0, 0, 0, 0, 17, 109
"f:\MANDARA10F\MANDARA10sourceCode10015\mandara10Ver10015\mandara2\frmMapEditorRelated\frmMED_makeMesh.Designer.vb", "Visual Basic", 233, 0, 0, 0, 0, 65, 5, 303
"f:\MANDARA10F\MANDARA10sourceCode10015\mandara10Ver10015\mandara2\frmMapEditorRelated\frmMED_makeMesh.vb", "Visual Basic", 647, 0, 0, 0, 0, 75, 83, 805
"f:\MANDARA10F\MANDARA10sourceCode10015\mandara10Ver10015\mandara2\frmMapEditorRelated\frmMapEditor.Designer.vb", "Visual Basic", 2350, 0, 0, 0, 0, 764, 6, 3120
"f:\MANDARA10F\MANDARA10sourceCode10015\mandara10Ver10015\mandara2\frmMapEditorRelated\frmMapEditor.vb", "Visual Basic", 1776, 0, 0, 0, 0, 96, 362, 2234
"f:\MANDARA10F\MANDARA10sourceCode10015\mandara10Ver10015\mandara2\frmMapEditorRelated\frmProjectionConvert.Designer.vb", "Visual Basic", 258, 0, 0, 0, 0, 65, 5, 328
"f:\MANDARA10F\MANDARA10sourceCode10015\mandara10Ver10015\mandara2\frmMapEditorRelated\frmProjectionConvert.vb", "Visual Basic", 57, 0, 0, 0, 0, 0, 5, 62
"f:\MANDARA10F\MANDARA10sourceCode10015\mandara10Ver10015\mandara2\frmPrintRelated\clsAccessory.vb", "Visual Basic", 2558, 0, 0, 0, 0, 388, 219, 3165
"f:\MANDARA10F\MANDARA10sourceCode10015\mandara10Ver10015\mandara2\frmPrintRelated\clsPrintMap.vb", "Visual Basic", 4852, 0, 0, 0, 0, 651, 424, 5927
"f:\MANDARA10F\MANDARA10sourceCode10015\mandara10Ver10015\mandara2\frmPrintRelated\frmPrint.Designer.vb", "Visual Basic", 433, 0, 0, 0, 0, 194, 5, 632
"f:\MANDARA10F\MANDARA10sourceCode10015\mandara10Ver10015\mandara2\frmPrintRelated\frmPrint.vb", "Visual Basic", 3908, 0, 0, 0, 0, 562, 210, 4680
"f:\MANDARA10F\MANDARA10sourceCode10015\mandara10Ver10015\mandara2\frmPrintRelated\frmPrint_3DSettings.Designer.vb", "Visual Basic", 254, 0, 0, 0, 0, 68, 5, 327
"f:\MANDARA10F\MANDARA10sourceCode10015\mandara10Ver10015\mandara2\frmPrintRelated\frmPrint_3DSettings.vb", "Visual Basic", 148, 0, 0, 0, 0, 0, 23, 171
"f:\MANDARA10F\MANDARA10sourceCode10015\mandara10Ver10015\mandara2\frmPrintRelated\frmPrint_DummyObjectGroup.Designer.vb", "Visual Basic", 262, 0, 0, 0, 0, 71, 5, 338
"f:\MANDARA10F\MANDARA10sourceCode10015\mandara10Ver10015\mandara2\frmPrintRelated\frmPrint_DummyObjectGroup.vb", "Visual Basic", 294, 0, 0, 0, 0, 0, 29, 323
"f:\MANDARA10F\MANDARA10sourceCode10015\mandara10Ver10015\mandara2\frmPrintRelated\frmPrint_Figure.Designer.vb", "Visual Basic", 1012, 0, 0, 0, 0, 272, 5, 1289
"f:\MANDARA10F\MANDARA10sourceCode10015\mandara10Ver10015\mandara2\frmPrintRelated\frmPrint_Figure.vb", "Visual Basic", 1234, 0, 0, 0, 0, 346, 44, 1624
"f:\MANDARA10F\MANDARA10sourceCode10015\mandara10Ver10015\mandara2\frmPrintRelated\frmPrint_FigureList.designer.vb", "Visual Basic", 169, 0, 0, 0, 0, 47, 5, 221
"f:\MANDARA10F\MANDARA10sourceCode10015\mandara10Ver10015\mandara2\frmPrintRelated\frmPrint_FigureList.vb", "Visual Basic", 317, 0, 0, 0, 0, 11, 12, 340
"f:\MANDARA10F\MANDARA10sourceCode10015\mandara10Ver10015\mandara2\frmPrintRelated\frmPrint_GoogleMapsFileOut.designer.vb", "Visual Basic", 563, 0, 0, 0, 0, 158, 5, 726
"f:\MANDARA10F\MANDARA10sourceCode10015\mandara10Ver10015\mandara2\frmPrintRelated\frmPrint_GoogleMapsFileOut.vb", "Visual Basic", 900, 0, 0, 0, 0, 58, 69, 1027
"f:\MANDARA10F\MANDARA10sourceCode10015\mandara10Ver10015\mandara2\frmPrintRelated\frmPrint_Instance.designer.vb", "Visual Basic", 38, 0, 0, 0, 0, 11, 5, 54
"f:\MANDARA10F\MANDARA10sourceCode10015\mandara10Ver10015\mandara2\frmPrintRelated\frmPrint_Instance.vb", "Visual Basic", 20, 0, 0, 0, 0, 0, 2, 22
"f:\MANDARA10F\MANDARA10sourceCode10015\mandara10Ver10015\mandara2\frmPrintRelated\frmPrint_KMLFileOut.designer.vb", "Visual Basic", 581, 0, 0, 0, 0, 152, 5, 738
"f:\MANDARA10F\MANDARA10sourceCode10015\mandara10Ver10015\mandara2\frmPrintRelated\frmPrint_KMLFileOut.vb", "Visual Basic", 730, 0, 0, 0, 0, 5, 77, 812
"f:\MANDARA10F\MANDARA10sourceCode10015\mandara10Ver10015\mandara2\frmPrintRelated\frmPrint_LinePattern.Designer.vb", "Visual Basic", 126, 0, 0, 0, 0, 35, 5, 166
"f:\MANDARA10F\MANDARA10sourceCode10015\mandara10Ver10015\mandara2\frmPrintRelated\frmPrint_LinePattern.vb", "Visual Basic", 103, 0, 0, 0, 0, 4, 14, 121
"f:\MANDARA10F\MANDARA10sourceCode10015\mandara10Ver10015\mandara2\frmPrintRelated\frmPrint_LinkEdit.Designer.vb", "Visual Basic", 147, 0, 0, 0, 0, 44, 5, 196
"f:\MANDARA10F\MANDARA10sourceCode10015\mandara10Ver10015\mandara2\frmPrintRelated\frmPrint_LinkEdit.vb", "Visual Basic", 107, 0, 0, 0, 0, 0, 10, 117
"f:\MANDARA10F\MANDARA10sourceCode10015\mandara10Ver10015\mandara2\frmPrintRelated\frmPrint_ObjectValue.Designer.vb", "Visual Basic", 133, 0, 0, 0, 0, 38, 5, 176
"f:\MANDARA10F\MANDARA10sourceCode10015\mandara10Ver10015\mandara2\frmPrintRelated\frmPrint_ObjectValue.vb", "Visual Basic", 35, 0, 0, 0, 0, 0, 3, 38
"f:\MANDARA10F\MANDARA10sourceCode10015\mandara10Ver10015\mandara2\frmPrintRelated\frmPrint_Option.Designer.vb", "Visual Basic", 2506, 0, 0, 0, 0, 671, 5, 3182
"f:\MANDARA10F\MANDARA10sourceCode10015\mandara10Ver10015\mandara2\frmPrintRelated\frmPrint_Option.vb", "Visual Basic", 584, 0, 0, 0, 0, 20, 79, 683
"f:\MANDARA10F\MANDARA10sourceCode10015\mandara10Ver10015\mandara2\frmPrintRelated\frmPrint_PointLineAdd.Designer.vb", "Visual Basic", 157, 0, 0, 0, 0, 38, 5, 200
"f:\MANDARA10F\MANDARA10sourceCode10015\mandara10Ver10015\mandara2\frmPrintRelated\frmPrint_PointLineAdd.vb", "Visual Basic", 109, 0, 0, 0, 0, 7, 10, 126
"f:\MANDARA10F\MANDARA10sourceCode10015\mandara10Ver10015\mandara2\frmPrintRelated\frmPrint_PrintOut.Designer.vb", "Visual Basic", 157, 0, 0, 0, 0, 41, 5, 203
"f:\MANDARA10F\MANDARA10sourceCode10015\mandara10Ver10015\mandara2\frmPrintRelated\frmPrint_PrintOut.vb", "Visual Basic", 128, 0, 0, 0, 0, 3, 22, 153
"f:\MANDARA10F\MANDARA10sourceCode10015\mandara10Ver10015\mandara2\frmPrintRelated\frmPrint_Property.Designer.vb", "Visual Basic", 309, 0, 0, 0, 0, 80, 5, 394
"f:\MANDARA10F\MANDARA10sourceCode10015\mandara10Ver10015\mandara2\frmPrintRelated\frmPrint_Property.vb", "Visual Basic", 518, 0, 0, 0, 0, 35, 42, 595
"f:\MANDARA10F\MANDARA10sourceCode10015\mandara10Ver10015\mandara2\frmPrintRelated\frmPrint_ScreenSetting.designer.vb", "Visual Basic", 109, 0, 0, 0, 0, 32, 5, 146
"f:\MANDARA10F\MANDARA10sourceCode10015\mandara10Ver10015\mandara2\frmPrintRelated\frmPrint_ScreenSetting.vb", "Visual Basic", 89, 0, 0, 0, 0, 0, 7, 96
"f:\MANDARA10F\MANDARA10sourceCode10015\mandara10Ver10015\mandara2\frmPrintRelated\frmPrint_SearchObjects.designer.vb", "Visual Basic", 101, 0, 0, 0, 0, 29, 5, 135
"f:\MANDARA10F\MANDARA10sourceCode10015\mandara10Ver10015\mandara2\frmPrintRelated\frmPrint_SearchObjects.vb", "Visual Basic", 113, 0, 0, 0, 0, 0, 4, 117
"f:\MANDARA10F\MANDARA10sourceCode10015\mandara10Ver10015\mandara2\frmPrintRelated\frmPrint_SeriesFileOut.designer.vb", "Visual Basic", 328, 0, 0, 0, 0, 89, 5, 422
"f:\MANDARA10F\MANDARA10sourceCode10015\mandara10Ver10015\mandara2\frmPrintRelated\frmPrint_SeriesFileOut.vb", "Visual Basic", 429, 0, 0, 0, 0, 66, 49, 544
"f:\MANDARA10F\MANDARA10sourceCode10015\mandara10Ver10015\mandara2\frmPrintRelated\frmPrint_SizeChange.designer.vb", "Visual Basic", 208, 0, 0, 0, 0, 56, 5, 269
"f:\MANDARA10F\MANDARA10sourceCode10015\mandara10Ver10015\mandara2\frmPrintRelated\frmPrint_SizeChange.vb", "Visual Basic", 76, 0, 0, 0, 0, 0, 8, 84
"f:\MANDARA10F\MANDARA10sourceCode10015\mandara10Ver10015\mandara2\frmPrintRelated\frmPrint_TileMapOut.designer.vb", "Visual Basic", 250, 0, 0, 0, 0, 74, 5, 329
"f:\MANDARA10F\MANDARA10sourceCode10015\mandara10Ver10015\mandara2\frmPrintRelated\frmPrint_TileMapOut.vb", "Visual Basic", 411, 0, 0, 0, 0, 3, 32, 446
"f:\MANDARA10F\MANDARA10sourceCode10015\mandara10Ver10015\mandara2\mandara10.vbproj", "XML", 0, 1531, 0, 0, 0, 7, 0, 1538
"f:\MANDARA10F\MANDARA10sourceCode10015\mandara10Ver10015\mandara2\mandara2.vbproj", "XML", 0, 944, 0, 0, 0, 7, 0, 951
"f:\MANDARA10F\MANDARA10sourceCode10015\mandara10Ver10015\mandara2\spatial.vb", "Visual Basic", 1861, 0, 0, 0, 0, 752, 175, 2788
"Total", "-", 124125, 26013, 7910, 212, 5721, 22830, 9057, 195868